Bedrooms,Bathrooms,Sqft_living,Floors,Grade,Sqft_above,Sqft_basement,Price
3,1,1180,1,7,1180,0,221900
3,2.25,2570,2,7,2170,400,538000
2,1,770,1,6,770,0,180000
4,3,1960,1,7,1050,910,604000
2,1,1680,1,6,1680,0,510000
4,4.5,5420,1,11,3890,1530,267800
3,2.25,1715,2,7,1715,0,257500
3,1.5,1060,1,7,1060,0,291850
3,1,1780,1,7,1050,730,229500
3,2.5,1890,2,7,1890,0,323000
3,2.5,3560,1,8,1860,1700,662500
